{
    "Tiles": [
      "################",
      "###-----########",
      "--#-------######",
      "##---------#---#",
      "##--------#-----",
      "-------#--------",
      "##----------#--#",
      "####--##########"
    ],
    "StylesFront": [
      "################",
      "#########?######",
      "################",
      "################",
      "rs##############",
      "################",
      "tt##############",
      "################"
    ],
    "StylesMiddle": [
      "aa##^/^#aa######",
      "bby#####bb######",
      "##y#######^###^#",
      "yy#########y####",
      "2223######y#####",
      "5556###y########",
      "5556########y###",
      "################"
    ],
  "StylesBack": [
      "----------######",
      "**********######",
      "**********-----#",
      "***************-",
      "****************",
      "****************",
      "***************#",
      "####**##########"
    ]
  }
  