{
    "Tiles": [
      "##########",
      "----------",
      "----------",
      "----------",
      "----#-----",
      "----#-----",
      "----------",
      "----------",
      "----------",
      "####--####"
    ],
    "StylesFront": [
      "##########",
      "##########",
      "##########",
      "##########",
      "##########",
      "##########",
      "##########",
      "##########",
      "##########",
      "##########"
    ],
    "StylesMiddle": [
      "###^/#^###",
      "##########",
      "#12222223#",
      "#45555556#",
      "#45555556#",
      "#45555556#",
      "#45555556#",
      "#78888889#",
      "##########",
      "##########"
    ],
  "StylesBack": [
      "----------",
      "**********",
      "**********",
      "**********",
      "**********",
      "**********",
      "**********",
      "**********",
      "**********",
      "####**####"
  
    ]
  }
  