{
    "Tiles": [
      "##########",
      "#-#---#-##",
      "#----#-#--",
      "------#-##",
      "----------",
      "-------#--",
      "----------",
      "#---------",
      "###-------",
      "####--####"
    ],
    "StylesFront": [
      "##########",
      "##########",
      "##########",
      "##########",
      "##########",
      "##########",
      "##########",
      "##########",
      "#?########",
      "##########"
    ],
    "StylesMiddle": [
      "###^/#^#aa",
      "y#w###y#bb",
      "y####y#y##",
      "######y#yy",
      "##########",
      "#123###F##",
      "#456######",
      "y789######",
      "yyy#######",
      "##########"
    ],
  "StylesBack": [
      "----------",
      "**********",
      "**********",
      "**********",
      "**********",
      "**********",
      "**********",
      "**********",
      "**********",
      "####**####"
    ]
  }