{
    "Tiles": [
      "##########",
      "#-#---#-##",
      "#----#----",
      "------#-##",
      "----------",
      "-------#--",
      "----------",
      "#---------",
      "###-------",
      "####--####"
    ],
    "StylesFront": [
      "##########",
      "##########",
      "##########",
      "##########",
      "##########",
      "##########",
      "##########",
      "##########",
      "##########",
      "##########"
    ],
    "StylesMiddle": [
      "###^/#^#aa",
      "z#w###z#bb",
      "z####z####",
      "######z#zz",
      "##########",
      "#123###C##",
      "#456######",
      "z789######",
      "zzz#######",
      "##########"
    ],
  "StylesBack": [
      "----------",
      "**********",
      "**********",
      "**********",
      "**********",
      "**********",
      "**********",
      "**********",
      "**********",
      "####**####"
    ]
  }