{
    "Tiles": [
      "################",
      "###-----########",
      "----------######",
      "##---------#---#",
      "##--------#-----",
      "-------#-------#",
      "##----------#--#",
      "####-###########"
    ],
    "StylesFront": [
      "################",
      "#########?######",
      "################",
      "################",
      "rs##############",
      "################",
      "tt##############",
      "################"
    ],
    "StylesMiddle": [
      "####^/^#aa######",
      "uCz#####bb######",
      "##########^###^#",
      "zz#########z####",
      "2223######z#####",
      "5556###z########",
      "5556########z###",
      "################"
    ],
  "StylesBack": [
      "----------######",
      "**********######",
      "**********-----#",
      "***************-",
      "****************",
      "***************#",
      "***************#",
      "####*###########"
    ]
  }