{
    "Tiles": [
      "##########",
      "----------",
      "----------",
      "----##----",
      "----##----",
      "----##----",
      "-----#----",
      "----------",
      "----------"
    ],
    "StylesFront": [
      "##########",
      "##########",
      "##########",
      "##########",
      "##########",
      "##########",
      "##########",
      "##########",
      "##########"
    ],
    "StylesMiddle": [
      "####/#####",
      "##########",
      "##########",
      "####cd####",
      "####ef####",
      "####gh####",
      "##########",
      "##########",
      "##########"
    ],
  "StylesBack": [
      "----------",
      "**********",
      "**********",
      "**********",
      "**********",
      "**********",
      "**********",
      "**********",
      "**********"
    ]
  }
  