{
    "Tiles": [
      "##########",
      "##########",
      "#--------#",
      "#--------#",
      "#-----####",
      "##----####",
      "###------#",
      "####--####",
      "####--####",
      "----------",
      "####--####",
      "####--####",
      "----------",
      "####--####",
      "####--####",
      "----------",
      "####--####",
      "####--####",
      "----------",
      "##----####",
      "------####",
      "###-------",
      "####--####"
    ],
    "StylesFront": [
      "##########",
      "##########",
      "##########",
      "##########",
      "#######xx#",
      "#######x##",
      "##########",
      "##########",
      "##########",
      "##########",
      "##########",
      "##?#######",
      "##########",
      "##########",
      "##########",
      "##########",
      "##########",
      "#########?",
      "##########",
      "rs########",
      "##########",
      "#?F#######",
      "##########"
    ],
    "StylesMiddle": [
      "#GHGHGHGH#",
      "#IJIJIJIJ#",
      "##########",
      "##########",
      "######vvE#",
      "#y####uuu#",
      "#yz#######",
      "##########",
      "#=#^##^#=#",
      "##########",
      "aaaa##aaaa",
      "bbbb##bbbb",
      "##########",
      "aaaa##aaaa",
      "bbbb##bbbb",
      "##########",
      "aaaa##aaaa",
      "bbbb##bbbb",
      "##########",
      "223###aaaa",
      "556###bbbb",
      "tt6#######",
      "##########"
    ],
  "StylesBack": [
      "#--------#",
      "#++++++++#",
      "#++++++++#",
      "#++++++++#",
      "#++++++++#",
      "#++++++++#",
      "#++++++++#",
      "####++####",
      "~~~~++~~~~",
      "**********",
      "**********",
      "**********",
      "**********",
      "**********",
      "**********",
      "**********",
      "**********",
      "**********",
      "**********",
      "**********",
      "**********",
      "55********",
      "####**####"
    ]
  }