{
    "Tiles": [
      "#################",
      "###-------------#",
      "##---------------",
      "##---------------",
      "##---------------",
      "##---------------",
      "##---------------",
      "##---------------",
      "-----------------",
      "##---------------",
      "##---------------",
      "##---------------",
      "##---------------",
      "##---------------",
      "###-------------#"
    ],
    "StylesFront": [
      "#################",
      "#################",
      "#################",
      "#################",
      "#################",
      "#################",
      "#################",
      "########!!!!#####",
      "########!!!!#####",
      "########!!!!#####",
      "########!!!!#####",
      "#################",
      "#################",
      "#################",
      "#################"
    ],
    "StylesMiddle": [
      "#################",
      "##K#############K",
      "#################",
      "#################",
      "#################",
      "#################",
      "#################",
      "#################",
      "#################",
      "#################",
      "#################",
      "#################",
      "#################",
      "#################",
      "##K#############K"
    ],
  "StylesBack": [
      "##~~~~~~~~~~~~~~~",
      "##***************",
      "##***************",
      "##***************",
      "##***************",
      "##***************",
      "##***************",
      "~~***************",
      "*****************",
      "##***************",
      "##***************",
      "##***************",
      "##***************",
      "##***************",
      "##***************"
    ]
  }