{
  "Tiles": [
    "############",
    "############",
    "############",
    "############",
    "############",
    "##-###----##",
    "##----------",
    "##----------",
    "##----------",
    "##----------",
    "------------",
    "##----------",
    "##----------",
    "##----------",
    "##----------"
  ],
  "StylesFront": [
    "############",
    "############",
    "####?#######",
    "############",
    "############",
    "############",
    "###########?",
    "############",
    "########!###",
    "#########!##",
    "########!###",
    "############",
    "############",
    "############",
    "############"
  ],
  "StylesMiddle": [
    "###a########",
    "###b#!######",
    "####!#######",
    "############",
    "##########aa",
    "##########bb",
    "############",
    "###!####M###",
    "############",
    "######12223#",
    "####M#45556#",
    "######45556#",
    "###z##78889#",
    "###########M",
    "##!##z######"
  ],
  "StylesBack": [
    "###~~~######",
    "###***######",
    "###***######",
    "###ijk######",
    "##~lmn~~~~~~",
    "##*opq******",
    "##**********",
    "##**********",
    "##**********",
    "~~**********",
    "************",
    "##**********",
    "##**********",
    "##**********",
    "##**********"
  ]
}